{
	"name": "Test world",
	"width": 8,
	"height": 8,
	"textures": [
		"texture.grass",
		"texture.walkway"
	],
	"data": {
		"ground": [
			[0,1,0,1,0,1,0,1],
			[1,0,1,0,1,0,1,0],
			[0,1,0,1,0,1,0,1],
			[1,0,1,0,1,0,1,0],
			[0,1,0,1,0,1,0,1],
			[1,0,1,0,1,0,1,0],
			[0,1,0,1,0,1,0,1],
			[1,0,1,0,1,0,1,0]
		],
		"objects": [
			
		]
	}
}